직원이 귀찮은 듯 내용을 회피하고  해결 방법을 상담원이 아닌 판매점 사원과 상담해서 해결하라고 하니 참말로 답답하다 	상담원
친절 감사요	상담원
이 똑바로 처리하세요	상담원
화면 보기 서비스 안 하게 해주세요 화면 보기 상담 서비스를 중요합니다 멘트 나올 때까지 대기하는 것 불편해요	상담/채널
타 회사 하나은행의 경우가 있으나 기재하긴 너무 기네요  지금도 기억나는 최고의 친절직원이어서 기억이 많이 남네요	기타
위에 내용이 롯데 상담사들이 친절하게 진행하는 방법 아다	기타
친절에 감사합니다  	상담원
친절한 상담 감사합니다 	상담원
통화연결은 상담사랑 통화하고 싶기 때문에 전화를 한 건데 디지털 ars 터치하라고 시간 끄는 게 불편하다	상담/채널
상담 대기 시간이 길지 않아 좋았습니다 	상담시스템
주말 상담원 연결 서비스 너무 좋습니다	상담시스템
상담원 연결 대기시간이 짧았으면 합니다	상담시스템
상담하시는 분들이 별로 친절하지가 않네요 좀 더 친절하게 응대 바랍니다	상담원
최근 삼성생명 상담 업무로 전화 이용 시 굉장히 편안하고 친절한 응대 서비스가 인상적이었습니다 물론 직원들마다 편차는 인정합니다만 짧은 시간 전달되는 상담원의 응대가 고객의 마음을 움직일 수 있다는 걸 기억해 주시길 바랍니다 	기타
친절한 상담 감사합니다	상담원
친절하시네요 감사합니다	상담원
친절하셨어요 감사합니다	상담원
상담원 전화 안내가 가장 빠른데 계속 보이는 ars로 안내하는 게 불편합니다	상담/채널
감사합니다 너무 친절했습니다	상담원
국민카드 발급 상담 시 연회비 및 기타 사항들을 꼼꼼한 비교 설명으로 카드 발급 선택을 맞춤형 카드로 발급받을 수 있게 친절했었던 상담원이 지금 생각해도 감사하네요	기타
친절한 상담  감사드립니다 	상담원
늘 만족하며 사용하고 있습니다  감사합니다 	삼성카드
자세하게 설명해주기	상담원
방금 상담받은 직원분 친절하지 않았습니다 좀 짜증이 느껴졌어요   	상담원
최선을 다하시고 몸 건강하세요	기타
친절에 감사드립니다   	상담원
친절한 상담 감사드립니다 	상담원
상담사와 통화대기시간이 너무 길어요	상담시스템
상담  내용 빨 라 처리되었음 합니다	상담원
삼성은 이 나라의 축이다 최선을 다해주길   	삼성카드
연회비 너무 비싸요	청구입금
연결되기까지 가 시간이 너무 길다	상담시스템
구경만 하고 가려고 했는데 친절하게 너무 설명을 잘 해주셔서 구매했습니다	기타
친절한 상담 감사합니다  	상담원
상담원과 상담 전엔 ARS 안내가 너무 길어서 불편합니다 	상담/채널
좀 더 친절했으면 좋겠음	상담원
친절하셔서 감사드립니다 	상담원
감사합니다  좋은 하루 보내세요	기타
신한카드의 OOO 직원의 경우 야간 분실 신고 상담 시간이었음에도 신속하고 책임감 있게 본인의 일처럼 상담하고 일 처리해줌	기타
친절 감사합니다	상담원
친절하게 해주셔서 감사합니다	상담원
잘하고 있어 다른 불편사항은 없습니다	기타
통화 연결 대기 시간이 너무 길지 않았으면 합니다 	상담시스템
친절한 상담 감사합니다  	상담원
전체적으로 친절합니다 감사합니다	상담원
상당원 친절도 형식적인 말투가 싫습니다	상담원
고객이야기의 공감 다이슨 고객센터 	기타
통화대기시간이 길다	상담시스템
무이자 할부 혜택이 있었으면 합니다	혜택
상담원 통화대기시간이 짧았으면  합니다	상담시스템
친절해서  감사했어요	상담원
다 카드사에서도  똑같은 상담을 받아봤었고 사용도 했었었는데 진심으로 고객의 입장을 들어주고 도와주려고 하고 친절하게 대하는 모습이 참 좋았었다	기타
상담원이 영결이 많이 힘이 듦	상담시스템
상담 연 거 바로 되어서 마우 만족	상담시스템
ars 연결 시 상담원 바로 연결하기가 불편합니다	상담/채널
Sk 텔레콤이 제일 친절한 편인데 친절하기 갸 막상막하엡니다	기타
상담원분이 친절하셨으면 좋겠네요	상담원
친절한 상담 감사드려요 	상담원
상담에 의한 정확한 답변이 아니었습니다 공부 많이 하시고 상담받으십시오	상담원
무이자 할부기간을 더 늘렸으면   	혜택
ARS  서비스  연결 시  제대로  연결이 안 되어  불편합니다 바로바로  상담원과  통화할 수 있게  손쉽게 연결이 되었으면 합니다	상담/채널
정말 친절하셨습니다 감사합니다	상담원
고객의  상담  필요시에  정확하고  친절한 상담  답변  부탁드립니다	상담원
친절 상담 감사드립니다	상담원
개인 정보 확인이 간편해서 좋았음	상담원
통화대기 연결이 빨리 되었으면	상담시스템
연회비 없는 카드가 있으면 좋겠어요   	청구입금
너무 친절하셔서 감사합니다	상담원
친절하게 해주셔서 감사합니다	상담원
맨 처음 화면엔 스마트 폰을 보면서 누르기 하는 게 생각보다 어렵네요	상담/채널
보이는 ARS 서비스를 원하지 않는데 자동으로 화면이 전환되어 불편합니다	상담/채널
친절하게 상담해주셔서 감사합니다  	상담원
통화대기시간이 너무 길었다	상담시스템
연회비가 넘나 비싸요	청구입금
친절상담 감사요	상담원
상담 질문에 대한 내용도 모르고 상담에 응함	상담원
상담원 연결 대기시간이 짧아졌으면 좋겠어요	상담시스템
삼성카드 상담 불편사항이 없음	삼성카드
대기시간 짧게 통화했으면 합니다	상담시스템
상담사와 통화 대기시간이 너무 길다	상담시스템
보이는 ARS 화면이 너무 불편하고 시간이 지체되어 답답하다	상담/채널
친절하다고 못 느낌	상담원
부가세 신고 시기에 맞게 바로 한 번에 연결 메뉴가 있어 너무 편했습니다  아이디어 낸 직원 꼭 포상해주세요  삼성카드 더 많이 애용하겠습니다 설문 5번 항목은 어쩔 수 없어서 1번 체크했습니다 	상담원
역시 삼성입니다	삼성카드
상담원이 내용을 모르고 답변	상담원
카드 취소되면 베네 포유 복지포인트 자동으로 복구시켜 주세요	라이프서비스
카드 배송 부분에서  배송처리업체  불성실한 대응과 배송직원의 약속 불이행이  전반적으로  카드의 첫 부분인데   그 부분이  아쉽다	카드상품
친절한 상담 감사드립니다  	상담원
친절하시고 감사합니다	상담원
화면으로 보는 디지털 ARS	None
엘지유플러스 직원의 친절함 적극성   	기타
연회비 부담	청구입금
좀 더 친절했으면 좋겠음	상담원
친절  감사합니다 	상담원
더 자세히 설명  주면 감사하겠음	상담원
상담원 연결까지 시간이 너무 걸린다	상담시스템
친절하게  상담 감사드립니다	상담원
무이자 혜택을 받는 데가 많이 없다	혜택
친절한  상담 감사합니다	상담원
감사하게 생각합니다	기타
친절에 감사합니다   	상담원
ARS  멘트  문의하는 대답을 잘 알아듣지 못해 여러 번 시도했다	상담/채널
대기시간이 길다 상담사와 통화가 힘들다	상담시스템
연회비가 비쌉니다	청구입금
글쎄요 sk  telecom도 많이 친절함	기타
친절하게 잘 상담해주셔서 감사합니다 	상담원
무이자 할부 혜택을 좀 많이줳으면좋겧어요  	혜택
골드회원이라  전화연결을  빨리해주니  감사합니다	상담시스템
디지털 연결이 잘 안됨	상담/채널
좀 더 친절했으면	상담원
상담 직원과 연결이 좀  신속했으면 좋겠네요	상담시스템
삼성카드 플래티넘 데스크 상담은 최고라고 생각한다  이유는 24시간이며  그것이 너무 좋다 	상담시스템
친절한 상담  감사합니다 	상담원
연회비가 저렴했으면  좋아요	청구입금
친절한 상담  감사	상담원
다급했는데 친절한 상담 감사합니다 	상담원
고객이 잘 못 들어 닷 질문하더라도  친절했으면 합니다	상담원
더 친절한 응대 원합니다	상담원
상담직원 없이 터치하는 것 매우 불편	상담/채널
친절한 상담 감사합니다   	상담원
복지포인트 사용이 너무 어려워요	라이프서비스
다른 카드가 휠씬 친절했습니다	기타
늘 친절할 필요 없는데  벽이랑 대화하는 느낌이네요 이름 말할 때만 친절하십니다 박 상담사님  	상담원
통화대기시간이 너무 길어요	상담시스템
친절하시네요 감사합니다 	상담원
스마트폰으로 상담하기가 너무 어려워요 보이는 ARS   음성 ARS 등   	상담/채널
친절하지 않음	상담원
기본 제공되는 카드 이용한 도 안내를 중단해주세요	상담/채널
친절하게 상담해주셔서 감사했습니다	상담원
삼성카드 안내원이 제가 질문하는 내용에 대해 잘 모르시는 거 같습니다  정확한 답변 숙지 부탁드립니다   질문자 본인과  같이 질문 내용 답안 알았지 못하고 답변 아무렇게 하는 건 너무 성의가 없습니다   가끔씩 기본기 없는 상담원 전화응대는 답답함만 배가시킵니다  모르면 다른 상담원에게 질문 넘겼으면 합니다 	상담원
연계된 제휴사  보험 안내 없는 카드사 돼주세요	고객정보관리
친절하게 상담해주신 안내자에게 감사합니다	상담원
통화 대기시간이 짧았으면 좋겠습니다  	상담시스템
다 카드사는  상담원들이  기계적인 것이 아닌  친절하게 응대함 삼성카드는  말도 빠르고  너무 기계 제인 응대만 함 고객의  요청사항을 잘 인지하지 못하는지 응대가  고객과 호응하는  감정이 부족함	상담원
불 친절하면 기분도 안 좋아해요	상담원
친절하게 상담해주어 감사합니다	상담원
상담원의 통화를 원할 때 너무 시간이 많이 걸려요	상담시스템
상담 한번 받으려면 보통 5분 이상 대기해야 실질 상담은 2분 미만인데	상담시스템
ARS 이용 시 화면 터치 방식이 너무 힘듦	상담/채널
힘든 시국에 상담원분들 고생해서 안쓰럽다	기타
OOO 님 친절하게 상담해주셔서 감사합니다	상담원
상담사와의   통화 대기시간의 지연	상담시스템
00카드는 상담하면 기분이 나빠집니다  삼성은 좋아요  	삼성카드
타 회사에서는 친근하게 답변 주셔서 상담도 편하게 느껴지고 상담 끝나고도 좋았던 것 같습니다	기타
자세한 설명이 매우 부족하다	상담원
삼성카드 상담받기 전에 LG U  상담했었는데 밝고 내가 궁금한 것들을 친절하게 알려주셔서 상담한 내가 다 기분이 좋았음 오늘 삼성 상담은 그냥 그랬음	상담원
상담원 연결이 어려워요  10번 이상 시도 해야 함	상담시스템
더욱 친절하셨으면 좋켔습니다	상담원
Sk Telecom의 친절과 전문성	기타
상담원과의 연결이빨리되었으면감사힘니다	상담시스템
하나카드 상담사 간결하고 친절하게 필요한 것만 구체적으로 설명해주어 이해하기 쉬웠음 	기타
제발 전화 좀 그만	고객정보관리
다른 카드사의 경우 삼성카드사 보다  통화대기시간이 짧다 	상담시스템
친절하게 상담해주어서 감사했습니다	상담원
만족합니다 사용함에	삼성카드
친절하게 상담해주어 감사드립니다	상담원
SKT 상담원들 짱 	기타
친절한 상담에 감사드려요	상담원
고객이 정확하게 모르고 있는 부분을 직원도 정확하게 몰라서  상담이 도움이 되지 않았다	상담원
보면서 하는 ars를 바로 권유하지 않고 처음에 보이는 ars와 음성 ars 중에서 선택하게 해주세요	상담/채널
하나은행은 친절히 잘 설명해줌	기타
상담원과의 통화 대기시간이 너무 길어요   	상담시스템
안내사항 설명하는 방법을 개선했으면 함	상담원
친절한 상담 감사요	상담원
친절하세요 감사합니다	상담원
친절하다는 느낌은 받지 못했음	상담원
친절상담 감사합니다	상담원
신속 정확한 답변을 원함 질문 내용 정확하게 파악하기	상담원
삼성카드는 그렇지 않겠지만 타 카드 회사는 보험회사와 연결되는 전화가 오는 경우가 많아서요 보험회사와의 연결은 없었으면 합니다 	고객정보관리
처음부터 화면 ARS로 접근되는 것이 아니라 음성과 보이는 ars를 선택할 수 있게 해주심 좋을 것 같습니다	상담/채널
조금만 친절히 답해주시면 감사하겠습니다	상담원
상담직원 교육 필요	상담원
친절한 상담 감사합니다 	상담원
문자상담이나 온라인 상담이 가능한 부분이 많아졌으면 좋겠습니다 	상담시스템
나이가 많은 사람들은 ARS 음성으로 바로 통화하기가 쉬운데 화면 보고 터치하는 게 쉽질 않습니다	상담/채널
신한카드사 상담 시스템이 맘에 듭니다 	기타
타 회사 카드는 더 친절하다	기타
화면 보면서 선택 불편	상담/채널
친절하게 해주셨어 감사합니다	상담원
신속 정확이  필요합니다	상담원
홈쇼핑  심지어 지마켓  정도도 상담사가 목소리가 상냥하고 친절해서  상담하고 나면 기분이 좋습니다  그러나 삼성카드 상담사는 상담하고 나서  불쾌하고 기분이 매우 나빴습니다  	상담원
두 번이나 같은 내용으로 상담을 했지만 각각 다른 상담원  제대로 처리가 되지 않음	상담원
친절하게 상담에 응해주어 너무 감사했어요	상담원
한화손해 보 럼 상담원분들은 정말 차분하고 정확하게 아주 만족스러운 상담을 하심	기타
문자로 바로바로 답변이오니 편리하고 좋아요	상담시스템
전화통화 시 상담원과의 통화가 되기까지 거치는 단계가  없이 연결되었으면 합니다	상담/채널
상담  감사합니다 	기타
우체국 콜센터 직원은 전화하니  고객 요구 사항을 빨리 파악하고 고객 입장에서 처리함 	기타
곧바로 상담직원으로 넘어가는 단축키가 있었으면 합니다	상담/채널
무이자 혜택 만족 긴 할부 만족 잘 쓰고 있습니다	혜택
화면 터치가 자꾸 실 수 되는 문제	상담/채널
친절상담 감사하네요	상담원
스마트폰 터치보다 먼저 음성 ARS가 되면 좋겠습니다  	상담/채널
고맙고 친절했습니다 감사합니다 	상담원
보이는 ars 무의미	상담/채널
KT 직원들과 상담했을 때의 불쾌감을 잊을 수가 없습니다 친철한 상담은 금세 잊히지만 따듯한 느낌은 오래가는 것 같습니다 	기타
Gs 상담은 정말 빠르게 처리 잘해주시고 다른 곳보다 신속 정확해서 실음이 가요	기타
전화 시 신속하고 빠르게 연결되었으면 좋겠습니다 또 상담원이 좀 더 친절했으면 합니다	상담원
상담에 감사	기타
연결 대기시간이 너무 길음	상담시스템
전화연결이 어려울 때가 가끔 있어요 그래도 타사 카드보다는 연결이 잘 돼요	상담시스템
짜증 없이 친절한 응대 부탁	상담원
신속 정확해주세요	상담원
연결이 빠르고 등급에 따라 주말에도 상담이 가능해서 만족	상담시스템
고객 입장에선 통화하기가 쉬웠으면 합니다	상담시스템
힘들지만 조금 더 친절하게 설명을 해 주었으면 합니다 	상담원
상담원 전화연결이 될 때까지 대기시간이 많이 길다	상담시스템
보이는 화면	None
모르니까 물어보는 건데 모른다고 혼내는 기분이 들	상담원
지금껏 상담받은 직원 중 최저네요 	상담원
상담원이 가장 웃음 목소리를 내면서 상담받을 때 화가 났습니다	상담원
터치식 화면	None
친절하게 상담 감사합니다	상담원
너무 친절했습니다 감사합니다	상담원
오늘은 상담이 좀 답답한 응대였습니다 	상담원
삼성전자 부장님 친절하게 설명해주셔서 감사드립니다 김치냉장고 구입하였습니다	기타
정확한 홈페이지 안내가 부족함	상담/채널
친절한 상담 감사합니다   	상담원
친절하여  감사합니다	상담원
상담원과의 통화대기시간이 너무 길다	상담시스템
삼성증권에서 받은 서비스  요청하지 않았지만 저의 조건에 맞는 설명과 사실을 따로 알아보시고 전화 주셔서 알려주는 적극적인 응대	기타
친절한 상담 감사합니다  	상담원
친절하게 상담 감사	상담원
대기할 때  연결  시간   	상담시스템
친절하고 상냥하였습니다  감사합니다 	상담원
친절하세요   감사합니다 	상담원
문의 내용 신속 정확 처리안 내 상담원 안내 미흡에 대한 교육	상담원
ARS로 업무처리가 너무 번거롭다	상담/채널
좀 더 친절한 상담이 되길	상담원
상담원 톤이 좋지 아니하네요	상담원
상담 직원과 연결하는 절차가 너무 복잡합니다 	상담/채널
화면 터치식은 너무 복잡하다	상담/채널
한도 상향 잘 올려 주셔서 감사	심사/한도
친절한 상담 감사합니다    	상담원
정확하게 설명이 필요하고 상담원 연결이 잘 안된다	상담원
친절한 상담에 감사합니다 	상담원
그저 상담은 복사 붙여넣기 시발놈들	상담원
다른 카드사에서는 조금 더 적극적으로 친절하게 상담	기타
상담원과의 연결 시간이 너무 길다	상담시스템
친절에 감사	상담원
친절상담 감사합니다	상담원
화면 연결	None
LG 고객센터 상담 여직원은 고객 문의가 잘 해결될 때까지 끝까지 확인 전화해서 상담했던 게 기억에 남는다	기타
상담하려면 많이 기다려야 하는 게 불편합니다 	상담시스템
친절하게  상담해주어서  감사하다	상담원
통화대기시간이 너무 길다	상담시스템
친절한 상담  감사합니다	상담원
채팅상담을 통한 처리가 편한 줄 몰랐고 사용해보니 좋았다 	상담시스템
대출 관련 마케팅 문자 권유 불쾌함	고객정보관리
9시 이전인데도 톡 상담이 되어서 놀랐습니다	상담시스템
상담원 연결 시까지  시간이 너무 걸림	상담시스템
좀 더 고객의 입장에서 응대해주시길	상담원
상담 감사합니다 	기타
디지털 ars 인터페이스가 상담원 연결로 이어지기 어려운 것 같음	상담/채널
감사합니다  삼성카드 직원분	기타
예컨대 SK Telecom의 상담직원들 응대 태도 처리 방식 등 직접 체험하여 좋은 점을 그대로 좀 배워 실행  Surprise 하게 해주시기 바랍니다	기타
친절한 상담 감사드립니다	상담원
고객 응대 시 고객이 원하는 바를 정확히 파악하여 빠른 처리 응대해주시면 더욱 좋겠습니다 	상담원
SKT 전화상담 끝나고 나면 항상 문자가 날라오는데 상담했었던 내용에 대한 부분과 상담 요청자가 이야기했던 내용을 담아 친절하게 보내주는 문자가 엄청 감동적이었음	기타
통화대기시간이 매우길다	상담시스템
주말과 공휴일에도 이용 가능하면 좋겠다	상담시스템
친절상담 감사합니다 	상담원
너무 말을 질질 끌면서 말하고 친절함보다 답답하다	상담원
고객의 입장에서 모든 가능성을 열어놓고 최선의 방법을 찾아주는 적극적인 상담이 됐으면 좋겠다	상담원
5번 질문에 대한 답변은 상담직원 연결되기까지 기다리는 것 말곤 없는 듯	상담시스템
보이는 디지털 AS는 너무 불편하게 되어있으며 원하는 화면이 보이지도 않습니다 첫 화면에 보이는 ars와 음성 ars를 바로 볼 수 있어야지요   	상담/채널
보이는 화면이 아니라 누르는 화면으로 상담하고 싶고 그게 더 전화상담하기까지 시간이 빠른데 누르는 화면으로 서비스 받으려면 보이는 화면 터치해달라고 할 때 15초 이상 듣고만 있어야 누르는 화면으로 넘어가서 너무 불편	상담/채널
고객에  입장에서 톤이나 상담을 해주셔야 한다고 생각됩니다 	상담원
1등 기업인 만큼 우수하다 생각함	삼성카드
바쁘신 시간대에 친절하게 상담해주셔서 감사드립니다	상담원
포인트를 좀 많이 주면 좋겠음	혜택
통화가 너무 힘들어요  대기시간	상담시스템
역시 삼성은 이 나라 제일 기업입니다 감사하고 긍지를 느낍니다	삼성카드
목소리에 친절함이 없다	상담원
OOO 님 친절상담 감사합니다	상담원
KT는 상담사 응답이나 확인도가 빠르고 정확했어요  참고하세요 	기타
한마디로 짜증 제대로 다시는 삼성 렌트 안 씁니다  여기도 담당 아니다 저기도 담당 아니다 정말 어디도 연락이 안 됨	리스렌탈상품
무이자 할부 자주 줬으면 좋겠다	혜택
연회비가 없는 거는 없나요	청구입금
화면을 보고  터치하는 것도 편하지만 처음에 화면 터치를 할 것인지 음성메시지를 듣고 할 것인지 구분할 수 있게 해주셨으면 좋겠습니다	상담/채널
2004년 SM 차를 구입하면서 삼성 캐피털에서 용자를 받았다  삼성 캐피털의 전화를 알아보는데 어려움이 있었다  르노 캐피털을 통해 삼성카드사로 합병되었다는 사실을 인지하는데 2시간이나 걸렸다 근저당설정 요건이 소멸되면 왜 본사에서는 해지를 하지 않을까  이 업무를 소비자의 몫으로 남겨 놓는다는 것은 이해가 안 된다  핸드폰 전화번호를 입력하라는데 16년 전 번호를 그대로 쓰는 사람이 얼마나 있을까 판매 시 서비스를 종료까지 해주길 바란다 	할부금융상품
카드 사용 시 포인트 적립이 적다고 생각됨	혜택
문자로 화면 보고하는 서비스 에러가 납니다 수고하십시오	상담/채널
나 같이 메일이나 앱을 못하는 사람을 위해 비밀번호와 생년월일을 한 번만 입력해 놓으면 다음에는 비밀번호만 입력하면 안 될까 하고 충언 드립니다	상담/채널
타 회사 전화상담 시에 알아들을 수 있을 때까지  설명해줌으로 해서 너무 고마움을 느낄 때가 있었습니다 	기타
전화 연결 대기 시간	상담시스템
무이자 할부 혜택 서비스를 제공해주시면 감사합니다	혜택
ars 상담직원 너무 많이 기다려야 하는 불편해요	상담시스템
상담원이 스크립트  읽으며 고객 응대하는 것이 부자연스럽고 친절하다는 느낌이 없음 	상담원
친절한 상담에  감사드립니다 	상담원
다른 회사 상담사분께 잘 몰라서 불안한 마음으로 문의했는데 내가 문의한 것에 대해 좋은 정보를 이야기해주어서  마음도 기쁘고 안심이 되었습니다	기타
상담원이 설명 권한을 더 높여주세요 그래야 정확히 대답하지요	상담원
친절하게 상담하여주셔서 감사합니다	상담원
Sk텔레콤에서 쉬운 말 설명과 그리고 신속한 연결과 상담 내용 문자로 설명 좋았어요	기타
친절하게 상담을 해주네요 감사합니다	상담원
친절하게 해주셔 감사합니다	상담원
상담사와 연결하는 과정이 너무 시간이 걸립니다	상담/채널
다른 카드사는 부드럽고 친절하게 연체미납 카드비를  설명해줘서 무한 감사를 했다아 주 친절하게	기타
연회비가 비싸요	청구입금
신한이 훨씬 친절하네요  삼성을 주로 이용했었는데 괜히 그랬나 싶어요	기타
친절하게 잘해주셔서 감사했습니다	상담원
화면으로 볼 수 있어 너무 좋아요	상담/채널
새벽에도 상담할 수 있어 좋았음	상담시스템
보이는 화면이 매우 불편해서 3번째에 연결 제대로 됨 	상담/채널
상담원 연결 대기 시간이 길지 않으면 합니다	상담시스템
골드회원 전용 전화 상담원 비치되어 있 으면 좋겠어요	상담시스템
친절하게 상담을 해주어서 감사합니다	상담원
친절한 상담 감사합니다  	상담원
친절하게 상담해 주셔서 감사합니다	상담원
친절해주셔서 감사	상담원
친절한 상담에 감사	상담원
문자를 보낸 내용에 출생연도 끝자리를 요일별로 처리한다는 내용을 추가해 주시면 좋을 것 같습니다 그래서 본인은 오늘 전화로 신청을 했다가 해당 요일이 아니라 신청을 못했습니다	생활편의서비스
연회비가 비싸다	청구입금
보험상담하면서 골절되면 500만 원 준다고 사기 침	기타
상담한 ARS가 너무 복잡함	상담/채널
상담 감사합니다 	기타
친절 상담 감사합니다	상담원
디지털 안내 제한	상담/채널
상담원과의 통화하려면 너무 오래 기다려야 하는데 좀 빨리 연결됐으면 좋겠어요	상담시스템
연회비가 너무 비싸요	청구입금
통화대기시간이 조금 많음	상담시스템
친절에 감사	상담원
 감사하다고 할게요 응대	기타
친절 감사합니다 	상담원
상담직원 통화가 없는 것처럼 되잇어서 답답하고 말이 너무 느림	상담원
광고 제발 놉	고객정보관리
신속	기타
친절 감사합니다  	상담원
디지털 ars 설명이 다소 깁니 더	상담/채널
친절 감사합니다 	상담원
100세 시대에 나이 든 상담자의 문의를 친절하고 불편함이 없이 상담해주는 직원과의 통회는 너무 고맙게  생각되는 다른 곳의 상담 시 느꼈던 마음입니다 	기타
친절하게 상담해주셔서 감사합니다	상담원
친절하고 감사합니다	상담원
상담직원과의 통화가 너무 힘들고 복잡함 	상담/채널
가끔 친절하지 안거나 빨리 끈으려 하거나 할 때	상담원
친절 감사	상담원
연회비 면제는 안 되나요	청구입금
상담하려 하는  기다리는 시간    너무 길다	상담시스템
좀 더 친절하여 쓰면	상담원
고마워요	기타
연결하는 대기시간 너무 길다	상담시스템
친절에  늘 감사하고 있습니다	상담원
형식적인 답변 대신 실질적인 빠른 업무처리를 기대합니다 	상담원
상담원님 감사합니다 	기타
친절하세요 감사합니다	상담원
ARS 메뉴가 너무 많고 불필요한 안내 멘트가 길게 나온다 빠르게 일 처리해야 되는 상황에선 여간 성가시다 형식적인 업무라 하지 말고 급히 처리해야 되는 고객 입장에서 생각하라	상담/채널
보이는 ARS 말고 기존 ARS 연결하는 방식이 먼저 나왔으면 좋겠네요	상담/채널
T  고객센터  상담원분들  상당히  친절합니다	기타
친절한 상담 감사합니다  	상담원
친절하셔서 그저 감사합니다	상담원
보험 안내해서 해지 했음	고객정보관리
상담직원과 통화할 때까지 너무 복잡함 선택 메뉴 좀 편했으면	상담/채널
지금껏 상담사들 중 말투가 제일 기분 나빴음   	상담원
고객 응대 시 말투가 상담 내내 거슬렸습니다 직원 교육 친절응대 이 절실하게 필요해 보입니다	상담원
상담번호를  남겼는데  너무  늦게  주심이  너무 불만입니다	상담시스템
화면을 구현하는 ars	None
연회비가 부담스러워요	청구입금
너무 친절해서 정말 감사했습니다	상담원
친절하게 상담해주심 감사드립니다	상담원
마케팅 활용 전화 시 미리 보험이면 보험이라고 얘기를 하고 통화 지속 여부 확인하고 통화했으면 좋겠습니다	고객정보관리
카드론 대출받은 거 상환이 앱에선 안되네요	상담/채널
친절하게 상담해주시니 감사합니다	상담원
디지털로 한번 다시 통화 연결이 아니라 예전처럼 바로 통화연결되었으면 좋겠습니다 	상담/채널
4번 5번 내용은 나한텐 맞지 않고 상담사 연결이 어려워 힘듭니다 사람이 많아서 그렇겠지요 그래도 항상 친절한 상담에 감사드립니다	상담원
Skt 통신사 콜센터 상담직원은 신속하고 부족한 부분은 확인해서 다시 알려줌 미안할 정도 친절함	기타
어떤 때엔 상담사와 통화하기까지 대기시간이 길었어요	상담시스템
삼성카드 톡 상담이 24시간인 줄 몰랐는데 너무 편리하네요 답장도 빠르게 주셨고요 매우 만족했습니다  	상담시스템
친절에  감사드립니다	상담원
친절상담에 감 사하다	상담원
짧은 통화연결 대기시간	상담시스템
친절 감사합니다	상담원
다른 카드 상담원은  고객이 뭘 원하는지 미리 응답해줌	기타
친절한 상담 감사합니다   	상담원
LG  상당히 친절하고 공감하고 상냥하고 도와주려 성의를 보임	기타
오키드 전담 콜센터 이용이 편리합니다	상담시스템
너무 오래 기다리고 상담이 늦어져요	상담시스템
친절하고 배려해주는 느낌이었는데 방금 상담사 분운 아니네요	상담원
상담원과의 통화대기시간이 너무 길다	상담시스템
친절한 상담에 감사드립니다 	상담원
친절하게 답해줘서 감사합니다 	상담원
상담원이 영혼 있는 답변을 원합니다 진정성 없는 답변은 기분이 나빴요	상담원
  전화상담 좀 빠르게 되었으면 좋겠어요	상담시스템
감사하고 친절하네요	상담원
SKT가 상담할 때 더 상냥하게 느껴져요 목소리에서도 미소가 느껴져요	기타
오늘 상담직원은 고객이 궁금한 사항을 바로 이해하지 못하고 같은 말을 반복하게 말하 친절하는 것처럼 보이나 동문서답인 것 같아	상담원
상담원이 고객이 말하는 걸 이해를 못 하고 두 번씩 새롭게 말을 해야  알아들음	상담원
친절하세요   감사합니다	상담원
국민카드 친절하고 서비스 최고입니다 삼성카드도 못지않고요	기타
상담원의 기분에 따라 회사마다 거의 비슷  전에 오랜 기간이 명했다가 한동안 쉬었는데    다시 쓰게 되어 기대를 해본다 삼성에 불만이 없었는데     꼼수 안 부리는 회사이길 바란다	삼성카드
너무 친절해서 감사	상담원
통화까지 거치는데 가 많다	상담/채널
안내 없이 터치 화면  안내원 연결하는데 어려웠음	상담/채널
친절하셔서 감사합니다   	상담원
상담원과의 통화대기시간이 좀 길었다	상담시스템
말투가 퉁명스럽고 친절한 말투가 아니라 기분 상 남	상담원
친절한 상담 감사합니다	상담원
해지 화면이 보이는 ars  등에도 있으면 좋을 듯	상담/채널
디지털 상담 메뉴가 복잡해서 도움이 안 되는 것 같음	상담/채널
자세히 안내하고 이렇게 시간 끌지는 않습니다 대답도 애매모호하지 않고 정확하게 응대합니다	상담원
밤늦게까지 상담해주셔서 감사합니다	기타
친절한  상담  감사합니다	상담원
24시간 콜센터 아주 만족합니다	상담시스템
연회비 업으면 좋겠어요	청구입금
친절한 상담 감사합니다   	상담원
터치 화면 어려움	상담/채널
통화 시 같이 연결되는 화면 서비스가 상당히 편하고 좋다	상담/채널
전화  연결을    빠른 시간에 연결  해면  합니다	상담시스템
Ars 화면 이용이 서툴러서 헤맺음	상담/채널
통화연결 시까지  시간이  너무 길다	상담시스템
골드회원은 ars 빨리 연결	상담시스템
타 회사에 불편 접수를 했는데 상담분이 엄청 미안해하시고 신속하게 처리 도와줘서 감동받음 친절하게 대응해주고 건강도 염려해주는 멘트가 두고두고 기억되네요	기타
친절에 감사  	상담원
친절하게 상담해주셔 감사합니다	상담원
상담 시간이 길고 직원들 교육 필요함	상담원
친절해서 좋았어요 감사합니다   	상담원
상담원과 연결되는 대기시간이 너무 길음	상담시스템
친절하십니다 감사합니다 	상담원
코로나 19때문에 힘들어하는데 조금 정확한 설명 필요함	상담원
고객이 기다리지 않게 안내 직원 확대 부탁합니다  	상담시스템
상담 감사합니다	기타
친절하고 기다리지 않게 하여 주기 바랍니다	상담원
화면으로 터치하는 ars는 불편함	상담/채널
보앱으로 처리하려 먼 찾기가 너무 힘들다	상담/채널
상담 내용에 맞게 적절한 대답이 해야 한다고 생각함	상담원
Skt에서 전화받으신 분이 잘 모르는 부분을 질문했어요  보통 담당하는 다른 부서로 넘기거나 할 텐데  본인이 직접 몇 시간 안에 그 건을 파악하고 공부를 해서 연락을 주시고 직접 안내를 해주시더라고요  상담자분이 뿌듯하게 안내해주시는 자신감 넘치는 안내를 들으며 저도 괜스레 기분이 좋았었네요  그만큼 회사에서 직원분을 위해 공부를 할 시간과 배려를 해줬으니 가능한 일이라 생각합니다 	기타
친절하게  해주셔  감사합니다	상담원
주말이나 공휴일에도 급한 업무를 처리할 수 있게  비상 상담원 배치 필요합니다 	상담시스템
친절하고 배려심 있는 상담에 감사합니다	상담원
SK 텔레콤 회사 직원들이 전화응대를 잘합니다 	기타
상담사 연결까지 대기 시간이 짧아서 좋았습니다 	상담시스템
대기시간이 너무 길다 통화만	상담시스템
그냥 바로 상담사로 연결되면 좋을 것 같아요 상담사 연결하려고 20분 동안 헤맸어요	상담/채널
주말에도 24시 상담사 연결 직접 되었으면	상담시스템
듣고 있는데 그것도 모르냐는 식의 답변이 돌아올 때 내가 알면 상담직원 하지 상담받고 있을까요   	상담원
상담원 통화 대기시간이 너무 길다	상담시스템
상담원 연결 시간이 너무 길고	상담시스템
정확하세요	기타
타사 카드 상담원님 친절함에 놀랐습니다 	기타
연결 시간 과다 	상담시스템
화면 터치로 인해 상담원 연결이 더 어려워졌음	상담/채널
쉽게 설명해주셨으면 합니다	상담원
친절하게 상담해주셔서 감사합니다 	상담원
친절하게 신속하게 처리가 됐으면 좋겠어요	상담원
OOO 님 너무 친절하게 알려주셔서 감사합니다    	상담원
더 친절했으면 좋겠습니다	상담원
친절한 상담해주셔서 감사합니다   	상담원
좀 더 친절하게 대해주셨으면 해요 형식적인 느낌이 강했어요 	상담원
통화대기시간이 너무 오래 걸림	상담시스템
상담 감사해요       	기타
스마트로 전화하니 보이는 화면으로 넘어가는데 상담원 통화 메뉴를 찾지 못해  불편하였음	상담/채널
직원이 퉁명스러움	상담원
친절하게 상담해주셔서 감사합니다   	상담원
오늘 상담 감사했습니다 	기타
상담직원이 너무 불친절하여 기분이 나빴습니다	상담원
상담원 연결까지 안 내가 너무 복잡합니다 디지털 서비스는 불편하고요	상담/채널
친절한 상담 감사했습니다 	상담원
통화 초반 카드 한도에 대한 아기가 너무 길어요  	상담/채널
친절합니다 감사합니다	상담원
문의하는 내용을 정확하게 인지하고 확실한 딥이 필요함	상담원
친절하다는 느낌을 받기 힘들 정도의 말투라서 상담 후 별로 기분이 좋지 않음	상담원
문자서비스 편리하고 좋습니다  	생활편의서비스
친절 감사합니다 	상담원
통화대기시간이 넘길 다	상담시스템
바로 보는 화면 서비스	None
주말상담에 감사합니다  	상담시스템
친절 감사드립니다	상담원
KB카드사는 문의 내용에 대해 친절히 듣고 하는 말에 대해 다 경청 후 안내를 해서 기분 좋은 통화를 했었어요	기타
상담원 통화가너믜힘듬	상담시스템
연회비 부담스러워요 무이자 할부 되는 곳 너무 제한적이어요 설사 삼성카드 무이자 할부가 할부가 되는데도 직원이 인지가 안 되어 있는 경우가 많아요	혜택
친절 감사합니다	상담원
다른 회사도 친절합니다	기타
응대가 정확하지 않다 항상 몇 번 재차 물어야 힌	상담원
골드회원이라고 별거 아닌 건 알지만 괜히 기분 좋고 상담원 연결이 빠르게 돼서 좋습니다	상담시스템
디지털 상담 안내시간을 기다리기 싫다 바로 누르는 ars 서비스로 가고 싶다	상담/채널
화면으로 터치하니 너무 편하고 대기시간 짧아 너무 좋습니다	상담시스템
상담 연결 대기시간이 너무 길다	상담시스템
친절상담 감사드립니다	상담원
친절한 상담 감사합니다   	상담원
카드 이용내역 1년 넘은 부분을 앱에서도 확인할 수 있었으면 좋겠습니다	상담/채널
곧바로 상담사 염결	상담시스템
고객의 입장에서 상담을 해주었으면 좋겠다	상담원
친절하고 감사했습니다	상담원
친절하셔서 감사했습니다	상담원
아파트 관리비 납부자 번호 있으면 카드 납부 가능했으면 합니다	생활편의서비스
4번 5번 질문 해당사항 없는데요	상담원
연회비가 비싸다	청구입금
다른 카드사보다 더  업무가 편리해서 좋아요	삼성카드
상담 감사	기타
너무 회사 위주이고 고객은 삼성동이다	삼성카드
친절한 상담에 감사드립니다	상담원
친절하시고 빠르세요 감사합니다	상담원
연회비를 저렴하게 부탁드려요	청구입금
친절하게 상담해주셔서 감사합니다 	상담원
연회비 너무 비싸다	청구입금
친절하고 속도감 있어 감사	상담원
5번 항 답변 내용 없음	상담원
신한 카드 상담 서비스가 더 친절하고 고객의 애로 사항을 해결하고자 노력합니다	기타
친절한 상담 감사합니다   	상담원
친절하게 상담해주셔서 감사합니다   	상담원
보이는 방법이 제대로안됨업	상담/채널
성의 없는 답변	상담원
다른 카드사 상담 직원은 매우  친절한데 오늘  상담 직원은 최악의 상담사	상담원
친절하고 감사했습니다 	상담원
상담 친절하게 받아주셔서 감사합니다	상담원
상담사와 빠른 시간에 통화되었으면 합니다	상담시스템
삼성전자 설치기사님들에 신속함에 감사합니다 	기타
늘 친절하셔서 감사합니다	상담원
친절하게 잘해주셨습니다  감사합니다	상담원
상담원 통화대기시간이 오래 기다림	상담시스템
친절하게 상담해주셔서 감사합니다  	상담원
친절하시네요 감사합니다  	상담원
친절상담해주셔서 감사하네요	상담원
친절한 상담에 감사합니다 	상담원
연회비는 낮추고 사용을 많이 하게 하는 전략으로 하십시오	청구입금
연회비가 너무 많음	청구입금
디지털 상담 불편함 고전 클래식이 나음	상담/채널
상담원 입장으로만 상담하지 마시길	상담원
간단한 절차로 카드 앱을 사용하면 좋게 없니다	상담/채널
회사 말씀은 드리지 않겠지만 중소회사지만 너무 친절하고  너무 쉽게 답변해주어  끝에 복 많이 받으시라는  이야기를  해준 적 있습니다	기타
영혼 있는 상냥함을 원합니다	상담원
친절하게 상담해주셔서 감사합니다	상담원
친절한  상담 감사합니다	상담원
너무 친절해주셔서 감사합니다	상담원
신한은행의 상담사에게 모바일 통한 추가 계좌 계설을 문의한 적이 있었는데  정말 친절하게 너무 성심성의껏 상담해주셔서 감동한 적이 있었다  전화 한 통화로 신한은행사의 좋은 기억만 계속 남게 된 사례 	기타
친절하게 대해주셔셔 감사드립니다 	상담원
제휴 보험회사 연락이 안 왔으면 해요	고객정보관리
친절하게  감사합니다	상담원
5번 질문 난해함  답할 내용이 없음	상담원
상담원 응대 아주 불친절	상담원
포인트 적립 많이 되게 해주세요	혜택
ARS 화면 보고하는 서비스는 연결도 잘 안되고 너무 별로임 개선 필요	상담/채널
골드회원 빠른 상담사 연결 감사합니다 	상담시스템
친절하게 상담해주셔서 감사드립니다	상담원
무이자 할부 많이 됐음 감사하겠습니다	혜택
연회비가 나에게는 비싸다	청구입금
친절해서 감사	상담원
말투가 상투적이고 투박하신데 친절하게 응대해주시면 좋겠습니다 	상담원
연회비 부담	청구입금
친절해서 감사합니다	상담원
상담직원과 통화하기가 힘들다	상담시스템
상담한 직원분이 끝까지 책임지고 해결해 주시는 부분은 다 카드사에서는 보기 힘든데 삼성카드는 그렇지가 않네요  	삼성카드
친절하게  상담해주셔서  감사합니다	상담원
상담원이 오늘 기분이 안 좋으신가 굉장히 불친절하시더라고요 	상담원
전화연결 시 디지털 ars 연결 외에도 상담원 연결을 바로 할 수 있었으면 좋겠습니다	상담/채널
연회비가 너무 비싸	청구입금
다른 궁금한 분분까지 있는지 체크해 주시는 친절함이 없음	상담원
친절하세요 감사합니다  	상담원
모바일 화면을 보고 상담 요청할 때 어느 항목에 터치해야 할지 몰라 사용하기 불편함	상담/채널
고객 말은 안 듣고 상담사 말만 함 예를 들면 질문을 하고 답변을 받은 후 확인차 다시 되물으면 다시 설명함 고객이 확인차 되물었을 때 답과 상담사가 다시 설명한 답은 똑같음 결론은 고객이 잘 이해한 게 맞는데 상담사는 틀렸단 식으로 다시 설명함	상담원
친절하셔서 감사합니다	상담원
친절에 감사합니다	상담원
디지털 ARS 화면에서 상담원과 직접 통화 선택하기가 쉽지 않음	상담/채널
무이자 할부 혜택이 더 많았으면 좋겠습니다	혜택
신한카드는 상담사 연결 시간은 짧아서 좋았습니다 반면 삼성카드는 넘기네요	상담시스템
친절이죠 감사합니다	상담원
OOO 상담원님 코로나 감염 조심하세요	기타
상담 직원분들 항상 감사드립니다	기타
친절 상담 감사합니다   	상담원
상담원과 연결하기가 복잡합니다 편리하게 상담원과 연결을 원합니다	상담/채널
상담원 통화연결이 빨리 되어 어 면합니다	상담시스템
오늘도 좋은 하루요	기타
친절한 상담 감사하고요 	상담원
친절한 상담에 감사드립니다 	상담원
친절하고 만족스러운 상담이었습니다 감사합니다	상담원
통화   대기시간이   너무 길다	상담시스템
친절한 상담 감사드립니다    	상담원
바로 보는 상담  ars 누르는 상담  전화상담사를 바로 고르게 해주세요	상담/채널
친절한 상담 부탁드립니다 	상담원
상담원 연결이 바로 될 수 있도록 하면 참 좋을 거 같아요 상담원과 통화연결되기까지 너무 복잡합니다  	상담/채널
통화 대기시간이 아닌  상담원과 통화하기 전의 진행과정이 너무 길다 	상담/채널
상담 톡이 부족	상담시스템
더욱더 발전한 신속한 상담 처리 기대합니다 3	상담원
좋았습니다  다만 보험 전화 좀 그만하셨으면 좋겠습니다  이미 가입한 보험이 있는데도 삼성카드로 연락 자주 오고 있습니다  있다고 받았는데도 집요하게 연락 와서 힘들었습니다 	고객정보관리
불만이 너무 많아요	기타
친절하게 응 다 말투 등등 듣는 사람이 불편함	상담원
좋은 하루 보내세요	기타
연회비 면제 카드로 알고 사용했는데 연회비를 슬쩍 청구하네요    참나  	청구입금
삼성카드 앱 너무 복잡합니다   앱을 깔아도 실상 필요한 부분을 찾기가 어려워 전화하게 만드네요  	상담/채널
친절에 감사합니다 	상담원
기다리는 시간 없이 상담원과 연결되었으면 합니다	상담시스템
상담원이 통화 중이라 많이 기다려야 해요	상담시스템
무이자 할부 혜택이 너무 부족하다고 생각합니다	혜택
1  통화연결 후 자동음성으로 화면 터치 요구 시 폰의 화면이 삼성 터치 화면으로의 전환이 안되거나 수차례 시도 후 가능 2  가족카드 관련 문의였으나 삼성 터치 화면엔 메뉴가 얹었음	상담/채널
상담 너무 감사했습니다	기타
친절하게 상담해주셔서 감사합니다	상담원
친절하게 답해줘서 감사합니다	상담원
상담직원과의 연결이 빠르게연결되면촣겠습니다	상담시스템
친절한 상담 감사합니다  	상담원
연회비가  비싸다	청구입금
상담원  전화 통화 대기 시간이 짧았으면 함	상담시스템
상담직원과 빠른 연결 부탁드립니다	상담시스템
너무 친절하십니다   감사합니다 	상담원
삼성카드 사용을 별로 하지 않아서 연회비가 부담스러워 해지할까 했는데  미리 알아서  연회비 면제 서비스를 해줘서  기분이 좋았습니다	청구입금
고객도 존댓말 하는데 상담원이 반말 투어로 상담함 굉장히 기분 나쁨 뭔 생각으로 저러는지 알 수 없음	상담원
오늘은  기분 좋게 빨리 응답해주어서 감사합니다 보통 때는 십분 정도 걸려으요	상담시스템
연령대를 감안해서  화면 터치보다는  ars가  좋아요	상담/채널
문의한 내용에 대한 정확한 답변 처리가 더 필요해 보입니다 고객의 말에 집중해서 상담해주셨으면 해요	상담원
화면을 보고하는 게 익숙지 않아서 음성으로 하는 게 더 편합니다	상담/채널
연회비 비싸요	청구입금
매우 친절하여 감사합니다	상담원
상담원과 통화한  대기시간이 너무 길어요	상담시스템
친절하게 상담해주셔서 감사합니다  이 세 롬니	상담원
다른 상담사에 비해 친절함 부족	상담원
친절하게 잘해주셔서 감사합니다	상담원
상담원도 공부를 해야 할듯합니다	상담원
잘 모르니까 상담 통화를 한 건데  짜증 내는 말투  답답하다는 말투로 상담을 받으니 기분이 나빴습니다 	상담원
보는 ars 상담은  불편함 상담원  전화가  편함	상담/채널
친절했습니다 감사합니다	상담원
상담원 연결까지 대기시간이 너무 길어요	상담시스템
  카드를 통한 통신료 전환 방법 및 call 이 아니더라도 internet 을 처리가 가능하도록 해 주세요 	생활편의서비스
친절 상담 감사	상담원
상담원 연결 대기 시간이 너무 길고 연결이 어렵습니다   	상담시스템
통화가 빨리 연결되기를	상담시스템
직원들에게 기초적인 발성법 교육을 시켜 표준어를 정확하게 발음하는 훈련을 시켰으면 합니다 	상담원
메인메뉴 넘어가기 전에 디지털 ars 안내가 가장 짜증 남	상담/채널
황상 수고하시는 상담 직원분들에게 감사하다는 말씀드리고 싶네요	기타
다 카드사도 마찬가지지만 상담원과의 통화하기 전 기다리는 시간이 너무 길어요	상담시스템
최초 연결 시 ai ars 연결 권유 없이 빨리 연결되면 좋겠어요	상담/채널
1  상담원과의 대화까지 소요되는 시간이 길어서 힘들었음 2   삼성카드사의 직원과 면대 면하여 질문 답변이 되길 수 있으면 좋겠습니다 	상담시스템
상담 감사드립니다	기타
연회비가 부담된다	청구입금
연회비를 저렴하게요	청구입금
통화대기시간 이 너무 길다	상담시스템
롯데카드 상담사님은 같은 질문에도 성의 있게 답변해주시고 친절히 설명을 잘해주셔서 삼성과 롯데 둘 중 카드 하나면 쓰라면 롯데만 쓰고 싶네요	기타
친절한 상담  감사합니다   	상담원
이해하기 쉽게 설명해주시면 감사하겠습니다	상담원
친절한 상담 감사드립니다	상담원
ARS 기계음은 짧게 바로 상담직원 연결로    수고하세요  	상담/채널
물어보면 답변을 못해	상담원
친절하게 담 면해주셔  너무 감사요	상담원
상담원 연결 창도 바로 연결될 수 있게 해주세요  디지털로 바로 돼서 불편합니다	상담/채널
친절한 상담 감사드려요 	상담원
상담원이 내용을 잘 이해하지 못함 정확한 답변 못함 발음 부정확 못 알아듣겠음	상담원
말씀이 너무 빠르고 고객이 궁금해서 질문하는 도중 너무 말을 자르는 경향이 있습니다  불편했어요  	상담원
무이자에 대한 혜택 서비스 많이 제공했으면 좋겠습니다	혜택
친절한 상담 감사드려요	상담원
전화 이용 시 메인화면에 디지털 화면 어렵습니다	상담/채널
친절 감사	상담원
다른 카드사 직원은 친절하십니다	기타
친절상담  감사	상담원
친절한 상담에 감사드립니다 	상담원
친절한 응 다 감사합니다 	상담원
애플이 상담 서비스임 전문성도 뛰어나고 여유롭고 친절하고 배려함 고급 호텔 식당에서 서빙 받는 느낌과 비슷함	기타
휴일 상담 감사	상담시스템
한화 생명  너무 신속   친절 	기타
너무 친절하셔서 감사합니다 	상담원
통화대기 시간 지체	상담시스템
너무 친절해서 감사했어요	상담원
친절 감사합니다	상담원
친절한 상담 감사합니다  	상담원
없음 좀 더 친절했으면 좋겠음	상담원
고객 입장에서  잘 듣고 요점만 정확하게 답변했으면 좋겠습니다 	상담원
친절하시네요  감사합니다 	상담원
이벤트 기간 외에도 5개월 이상 무이자 할부 혜택 자주 많았으면 합니다 	혜택
ARS 지동 응답 불필요한 안내 축소 상담직원과 빠른 연결을 원합니다  추석 연휴 잘 보내세요	상담시스템
친절하게 되어주어 감사합니다	상담원
친절에 감사드립니다  	상담원
처음 걸자마자 보이는 ars라고 터치하는 거 data만 소비되고 별로네요	상담/채널
오늘 통화한 114고객센터 직원분인데 긴 질문에도 너무 상냥하고 친절하고 말투 속에 스마일을 하고 응대하는 모습을 느꼈습니다 끝까지 기분 좋게 통화하고 나의 기분까지 좋게 만들어주는 것 같아 행복감도 느꼈습니다 	기타
핸드폰 화면 터치 내용이 너무 많음	상담/채널
화면 터치로 넘어가는 게 너무 불편함	상담/채널
오늘같이 상담원 연결이 원활히 되어 좋았습니다 	상담시스템
친절하게 응해주셔 감사합니다	상담원
무이자 할부 혜택이 왜 없나요	혜택
화면 터치  불편해요	상담/채널
ARS 이용 시  안내하는 내용이 너무 길어서 끝까지 듣는 것이 힘들다  상담원과의 통화하고 싶어서 하는 전화인데  다른 안내 말이 너무 많고 길어서 힘들어요	상담/채널
상담할 때도 친절하지 않다는 느낌이었는데 상담 후 수고하세요라고 인사하는데 상담사가 먼저 전화를 뚝 끊어버리시더라고요 삼성카드뿐 아니라 다른 곳에서 상담했을 때도 이런 경우가 없었는데 참 당황스러웠습니다	상담원
고객중심의 상담이 되었으면 합니다	상담원
삼성카드 연회비가 너무 바 쌉니다    	청구입금
친절한  상담 감사합니다 	상담원
친절에 감사합니다	상담원
연회비가 너무 비싸다	청구입금
대출 상환도 앱에서 처리되도록 개선	상담/채널
친절한 상담   감사합니다	상담원
친절해서 감사합니다 	상담원
SK텔레콤도 노인 배려로 차분하고 이해 돕기에 최선을 다하고 있어요	기타
삼성 팬입니다   현제 만족합니다	삼성카드
4번 5번 문항 답변 불편한 게 없었는데 체크하라고 강요합니다 상담원분들 더우신데 고생하십니다 좋은 하루 보내세요	상담원
상담원과의 통화 대기시간이  짧았으면  좋겠음	상담시스템
디지털 상담 없애라 너무 불편하다	상담/채널
친절한 상담 감사합니다   	상담원
정확한 안내와 신속한 처리 부족합니다 직원들 역량 강화로 전문적이고 책임지는 상담을 부탁합니다	상담원
상담사 연결까지 시간이 많이 걸리네요	상담시스템
잘햇은데 친절이 좀 부족합니다	상담원
무이자 할부 자주 많이 주셔서 감사합니다	혜택
친절한 상담 감사드립니다	상담원
끝가지 고객 입장에서 상실하게 답변을 해주시길 바랍니다	상담원
친절하게 잘하고 계심 감사드립니다 	상담원
친절한 세서 감사합니다	상담원
너무 친절해서 감사합니다	상담원
바로 상담원으로 연결이 안 되고 화면상으로 연결하는 게  어렵다	상담/채널
화면 터치식에서 음성 ars로 돌아가는 버튼이 잘 찾아지지 않음	상담/채널
매우 친절하셨습니다 감사합니다	상담원
친절하게  상담해주셨어 감사했습니다	상담원
친절상담과 상담원에  친절에 대단히 감사합니다	상담원
스마트폰 상단 터치해서 화면 나오는 방식 편하지 않습니다 불편해요	상담/채널
친절한 상담 너무 감사합니다	상담원
신한카드사 직원분들은 친절하고 미리 예상해서 말씀해주셔서 대화가 편하고 좋습니다	기타
롯데카드사는  친절하게도  방법을  알켜줍니다	기타
오늘은 불만투성이	기타
연회비가 너무 비쌈	청구입금
친절하게 상담해주셔서 감사합니다   	상담원
친절하게 상담해주셔서  감사합니다	상담원
상담받으려면 오래 기다리는 게 불편함	상담시스템
친절해서 감사합니다	상담원
연회비가 너무 비싸요	청구입금
자세한 설명과 시간 좀 길게 대화하면서 설명을 해주셨으면 감사합니다	상담원
불만	기타
골드고객으로 지정되어 있어 빠른 안내 서비스를 받을 수 있어 좋았다   향후 오랜 고객에게 감동하는 서비를 제공해 주세요 	상담시스템
삼성카드 앱이 많이 느려서 불편합니다	상담/채널
상담 감사했어요	기타
친절하고 감사합니다	상담원
답변할 때 확실하게 알고 답변해줬으면 좋겠어 요전에 다른 상담사와 상담할 때 좀 그랬거든요	상담원
너무 감사합니다 친절하셨어요	상담원
포인트  적립되는 게 많았으면	혜택
빠른 시간 내에 상담원 연결을  했으면 좋겠습니다	상담시스템
친절하게 해주셔서 감사합니다	상담원
타사 카드 상담원은 다 친절했음	기타
포인트 적립이 더 높아지면   	혜택
쓸데없이 전화하지 않았으면 좋겠습니다 	고객정보관리
현대카드 친절하더라고요	기타
안 기다리고  빨리 상담되었으면 좋겠다	상담시스템
친절하셔서 감사합니다 	상담원
다른 회사 직원들도 다 친절하게 받습니다	기타
상냥하고 친절했으면 좋겠습니다 	상담원
친절하게 상담해주어서 감사합니다	상담원
형식적인 답변 말고  상담자가 묻고자 하는 내용을 친절하게 잘 알려주십시오	상담원
무이자 사용 혜택을 기대합니다   	혜택
더욱 친절합시다	상담원
관리비 혜택이 없어 해지함	생활편의서비스
통화대기 시간을 줄였으면   	상담시스템
조금만 빨리 처리했으면 좋겠다 조금 친절	상담원
전화하면 바로 보이는 ARS로 넘어가는데 참 불편해요 음성 보이는 화면 둘 중 번호로 선택할 수 있었으면 좋겠어요	상담/채널
연회비가  너무 비싸고요	청구입금
친절하게  상담 잘 받고  감사합니다 	상담원
통화 대기시간이 너무 길다	상담시스템
친절 감사드려요	상담원
상담원 통화가 빠르게 연결이 되었으면 좋겠습니다	상담시스템
고객 전화에서  디지털에 취약한  고객들이 상담원 연결이  매우  불편하게 되어있음	상담/채널
친절하게 상담해주셔서 감사합니다  	상담원
상담원 통화 화면이  크게 나왔으면 좋겠음	상담/채널
친절하게 상담 감사합니다 	상담원
실시간 채팅상담 만들어주세요	상담시스템
친절상담 감사합니다  	상담원
앱에서 내 카드 결제나 사용한도를 쉽게 알 수 있게끔 만들어주세요	상담/채널
상담원 연결까지 누르는 것도 많고 기다리는 것도 많았네요	상담/채널
Sk텔레콤은 항상 친절하고 문의사항 더 있나 물어봐 줌	기타
응대 감사	기타
OOO 님의 친절에 감사드립니다   	상담원
친절하셔서 감사했습니다	상담원
롯데카드 상담 시 바로바로 문제를 해결해주고 답변도 여러 가지 방법으로 알려준다	기타
친절한 상담 감사합니다   	상담원
친절한 상담 감사합니다   	상담원
배송직원 매우  불친절 아주 많이  	카드상품
화면 상담 서비스	None
다른 제유 보험회사 전화 불미스럽습니다	고객정보관리
친절하셔서 감사했습니다 	상담원
골드회원 전용 상담제도	상담시스템
화면을 터치하며 상담하는 점	상담/채널
상담 감사해요	기타
헝산 친절해서 감사합니다	상담원
Sk텔레콤 상담 직원들요 예전 경험인데요  진심으로 대화하는 느낌이 확실히 좋았던 기억이 있습니다	기타
주말임에도 불구하고 서비스를 받을 수 있다는 게 감동입니다 항상 감사합니다	상담시스템
상담직원이 질문의 이해도가 부족함	상담원
상담직원대기시간이 짫았으면 한다	상담시스템
보이는 에이 알 에스 멘트 계속 나오지 않았으면 해요 나중엔 음성으로 나왔지만 처음에 선택권이 있으면 좋겠죠	상담/채널
친절한 상담에 감사합니다 	상담원
너무너무 친절 감사합니다	상담원
고객이 모르는 것에 대해서 물어보면 친절하게 응대해주세요  말투가 무시한다는 느낌을 받았습니다  그리고 상담사 억양이 사투리인 거 같은데 통화 내내 거슬려고요 	상담원
언행을 좀 친절하게 대응했으면 좋겠습니다 	상담원
너무 친절상담해주셔서 감사합니다	상담원
궁금사항 너무 많아 시간이 걸렸음에도 끝까지 친절하게  자상하게  답해주신 일에 대해 감사함을 느낌  다른 회사 	기타
통화 대기 시간이 너무 길어요   	상담시스템
좀 더 친절했으면 좋겠다	상담원
가장 최고로 좋은 점은 빠른 음성통화 연결 폰 화면에  터치 화면이 같이 뜨는 것이  타사에 비해 압도적인 편리함	상담/채널
챗봇상담은 원하는 메뉴가 잘 없습니다	상담/채널
친절한 상담 감사드립니다   	상담원
상당 직원 연결이 잘 안됨	상담시스템
친절한 상담 감사합니다   	상담원
상담까지 번호눌로야되는게넘먾아요	상담/채널
상담사가 불친절한 느낌을 받았네요 상담이 귀찮다는 듯으로 받아들여져서 기분이 좋지만은 않네요	상담원
친절상담 감사	상담원
음성으로 상담을 받고 싶은데 카톡 상담 참으로 넘어가는 시스템 매우 불편함  	상담/채널
전화연결 시  대기시간이 길다	상담시스템
친절한 상담에 감사드립니다   	상담원
OOO 상담원 본인의 선입견으로 고객 응대를 하여 큰 불편을 줌	상담원
문의 내용에 대해 자세히 설명해주세요   	상담원
문자나  메일로  상품 광고 안내를 했으면 좋을 듯   근무 중 상품 광고를 전화를 받으면 화가 남 	고객정보관리
가장 좋은 카드회사입니다	삼성카드
친절하게 상담해줘서 감사합니다	상담원
처음에   화면을  보면서  상담 시    화면이   자꾸  움직이면서   무엇을 선택해서   문의해야   하는데   혼란스러웠다   이것은   반드시  개선해야  한다	상담/채널
통화대기시간이 넘길다	상담시스템
고객이 필요한  상담을 빠르고 정확한 처리를 해주신 감사하겠습니다	상담원
무이자 할부를 좀 더 많이 해주면 감사하겠습니다	혜택
통화연결 시간이 길다	상담시스템
친절도 매 유부족	상담원
보이는 상담은 원하는 내용 찾기 힘든 경우가 많은	상담/채널
보이는 화면을 통해 화면을 누를 때  다소 헷갈려요 글씨가 너무 많고 작아서 더 간결하면 좋을 것 같아요	상담/채널
통화연결 대기시간이 길다	상담시스템
Ars 연결하면 디지털로 넘어가 상담원 연결이 어려웠다	상담/채널
